+++++++....+++++++...++++++....+
...C...............F...+++....+.
......+++...++++++....+........+
...++..............+..........++
++......++F....++....++++.......
++++....F......+++.........+++..
