+++++++....+++++++...++++++....+
...C...............F...+++....+.
......+++...++++++....+........+
...++............+............++
++......++F....++....++++.......
++++....F......+++.........+++..